filas=10
columnas=34
gasolinera=2,7
gasolinera=6,5
gasolinera=9,10
gasolinera=7,16
gasolinera=6,21
gasolinera=6,26
1111111111111111123456665543221111
1111111111111111122345655443322111
1112221111111111112234544332221111
1112232111111#11111234433221111111
1122343211111#11111123222111111111
1112232111111#11111112211111111111
111142111111#########2322111111111
111111#######111111123433221111111
1111111111111111111123433222111111
1111111111111111111223454432221111
